BBBBBBBBBBBBBBBBBBBBBB
BSSSSSSBSSSSSSBSSSSSSB
BSSSSSSBSSSSSSBSSBBSSB
BSSSSSSBSSSSSSBSSBBSSB
BSSSSSSBSSSSSSBSSSSSSB
BBBBBBBBBBBBBBBBBBBBBB
SSSBBSSSSSSSSSSSSBBSSS
SSSRRSSSSSSSSSSSSRRSSS
RRRRRRRRRRRRRRRRRRRRRRSSYYYYYYYY
RSSSSSSRSSSSSSRSSSSSSRSSYSSSSSSY
RSSRRSSRSSSSSSRSSSSSSRRYYSSSSSSY
RSSRRSSRSSSSSSRSSSSSSRRYYSSSSSSY
RSSSSSSRSSSSSSRSSSSSSRSSYSSSSSSY
RRRRRRRRRRRRRRRRRRRRRRSSYSSSSSSY
SSSSSSSSSSRRSSSSSSSSSSSSYYYYYYYY
SSSSSSSSSSwwSSSSSSSSSSSSYSSSSSSY
SSSSSSSwwwwwwwwwwwwwwwSSYSSSSSSY
SSSSSSSwSSSSSSwSSSSSSwSSYSSYYSSY
SSSSSSSwSSSSSSwSSSSSSwwYYSSYYSSY
SSSSSSSwSSSSSSwSSSSSSwwYYSSSSSSY
SSSSSSSwSSSSSSwSSSSSSwSSYSSSSSSY
SSSSSSSwwwwwwwwwwwwwwwSSYYYYYYYY