xBBBBBBBBBBBBBBBBBBBBBBx
xB0SSSSS B1SSSSS B2SSSSS Bx
xBSSSSSSBSSSSSSBSSBBSSBx
xBSSSSSSBSSSSSSBSSBBSSBx
xBSSSSSSBSSSSSSBSSSSSSBx
xBBBBBBBBBBBBBBBBBBBBBBx
xSSSBBSSSSSSSSSSSSBBSSSx
xSSSRRSSSSSSSSSSSSRRSSSx
xRRRRRRRRRRRRRRRRRRRRRRSSYYYYYYYYx
xR4SSSSS R5SSSSS R6SSSSS RSSY7SSSSS Yx
xRSSRRSSRSSSSSSRSSSSSSRRYYSSSSSSYx
xRSSRRSSRSSSSSSRSSSSSSRRYYSSSSSSYx
xRSSSSSSRSSSSSSRSSSSSSRSSYSSSSSSYx
xRRRRRRRRRRRRRRRRRRRRRRSSYSSSSSSYx
xSSSSSSSSSSRRSSSSSSSSSSSSYYYYYYYYx
xSSSSSSSSSSwwSSSSSSSSSSSSY11SSSSSYx
xSSSSSSSwwwwwwwwwwwwwwwSSYSSSSSSYx
xSSSSSSSw9SSSSS w10SSSSSwSSYSSYYSSYx
xSSSSSSSwSSSSSSwSSSSSSwwYYSSYYSSYx
xSSSSSSSwSSSSSSwSSSSSSwwYYSSSSSSYx
xSSSSSSSwSSSSSSwSSSSSSwSSYSSSSSSYx
xSSSSSSSwwwwwwwwwwwwwwwSSYYYYYYYYx