xBBBBBBBBBBBBBBBBBBBBBBSSGGGGGGGGx
xB0SSSSS B1SSSSS B2SSSSS BSSG3SSSSS Gx
xBSSSSSSBSSSSSSBSSBBSSBBGGSSSSSSGx
xBSSSSSSBSSSSSSBSSBBSSBBGGSSSSSSGx
xBSSSSSSBSSSSSSBSSSSSSBSSGSSSSSSGx
xBBBBBBBBBBBBBBBBBBBBBBSSGGGGGGGGx
xSSSBBSSSSSSSSSSSSBBSSSSSSSSGGSSSx
xSSSRRSSSSSSSSSSSSYYSSSSSSSSYYSSSx
xRRRRRRRRRRRRRRRSSYYYYYYYYYYYYYYYYx
xR4SSSSS R5SSSSS RSSY6SSSSSS Y7SSSSS Yx
xRSSRRSSRSSSSSSRSSYSSSSSSSYSSSSSSYx
xRSSRRSSRSSSSSSRSSYSSSSSSSYSSSSSSYx
xRSSSSSSRSSSSSSRSSYSSSSSSSYSSSSSSYx
xRRRRRRRRRRRRRRRSSYSSSSSSSYSSSSSSYx
xSSSSSSSSSSRRSSSSSYYYYYYYYYYYYYYYYx
xSSSSSSSSSSwwSSSSSY10SSSSSSY11SSSSSYx
xSSSSSSSwwwwwwwwSSYSSSSSSSYSSSSSSYx
xSSSSSSSwSSSSSSwSSYSSSSSSSYSSYYSSYx
xSSSSSSSwSSSSSSwwYYSSSSSSSYSSYYSSYx
xSSSSSSSwSSSSSSwwYYSSSSSSSYSSSSSSYx
xSSSSSSSw9SSSSS wSSYSSSSSSSYSSSSSSYx
xSSSSSSSwwwwwwwwSSYYYYYYYYYYYYYYYYx