RRRRRRRRSSBBBBBBBBBBBBBBBSSGGGGGGGG
R0SSSSS RSSB1SSSSS B2SSSSS BSSG3SSSSS G
RSSSSSSRRBBSSSSSSBSSBBSSBBGGSSSSSSG
RSSSSSSRRBBSSSSSSBSSBBSSBBGGSSSSSSG
RSSSSSSRSSBSSSSSSBSSSSSSBSSGSSSSSSG
RSSSSSSRSSBBBBBBBBBBBBBBBSSGGGGGGGG
RSSSSSSRSSSSSBBSSSSSBBSSSSSSSSGGSSS
RRRRRRRRSSPPPPPPPPSSYYSSSSSSSSYYSSS
R4SSSSS RSSP5SSSSS PSSYYYYYYYYYYYYYYY
RSSSSSSRSSPSSSSSSPSSY6SSSSS Y7SSSSS Y
RSSRRSSRSSPSSSSSSPSSYSSSSSSYSSSSSSY
RSSSSSSRSSPSSSSSSPSSYSSSSSSYSSSSSSY
RSSSSSSRSSPSSSSSSPSSYSSSSSSYSSSSSSY
RRRRRRRRSSPPPPPPPPSSYSSSSSSYSSSSSSY
SSSRRSSSSSSSSPPSSSSSYSSSSSSYSSSSSSY
SSSwwSSSSSSSSwwSSSSSYYYYYYYYYYYYYYY
wwwwwwwwwwwwwwwwwwSSY10SSSSSY11SSSSSY
w8SSSSSS w9SSSSSSS wSSYSSSSSSYSSSSSSY
wSSSSSSSwSSSSSSSSwwYYSSSSSSYSSYYSSY
wSSSSSSSwSSSSSSSSwwYYSSSSSSYSSYYSSY
wSSSSSSSwSSSSSSSSwSSYSSSSSSYSSSSSSY
wSSSSSSSwSSSSSSSSwSSYSSSSSSYSSSSSSY
wwwwwwwwwwwwwwwwwwSSYYYYYYYYYYYYYYY

