RRRRRRRRSSBBBBBBBBBBBBBBBSSGGGGGGGG
R0SSSSS RSSB1SSSSS B2SSSSS BSSG3SSSSS G
RSSSSSSRRBBSSSSSSBSSBBSSBBGGSSSSSSG
RSSSSSSRRBBSSSSSSBSSBBSSBBGGSSSSSSG
RSSSSSSRSSBSSSSSSBSSSSSSBSSGSSSSSSG
RSSSSSSRSSBBBBBBBBBBBBBBBSSGGGGGGGG
RSSSSSSRSSSSSBBSSSSSBBSSSSSSSSGGSSS
RRRRRRRRSSBBBBBBBBSSYYSSSSSSSSYYSSS
R4SSSSS RSSB5SSSSS BSSYYYYYYYYYYYYYYY
RSSSSSSRSSBSSSSSSBSSY6SSSSS Y7SSSSS Y
RSSRRSSRSSBSSSSSSBSSYSSSSSSYSSSSSSY
RSSSSSSRSSBSSSSSSBSSYSSSSSSYSSSSSSY
RSSSSSSRSSBSSSSSSBSSYSSSSSSYSSSSSSY
RRRRRRRRSSBBBBBBBBSSYSSSSSSYSSSSSSY
SSSRRSSSSSSSSBBSSSSSYSSSSSSYSSSSSSY
SSSwwSSSSSSSSwwSSSSSYYYYYYYYYYYYYYY
wwwwwwwwwwwwwwwwwwSSY10SSSSSY11SSSSSY
w8SSSSSS w9SSSSSSS wSSYSSSSSSYSSSSSSY
wSSSSSSSwSSSSSSSSwwYYSSSSSSYSSYYSSY
wSSSSSSSwSSSSSSSSwwYYSSSSSSYSSYYSSY
wSSSSSSSwSSSSSSSSwSSYSSSSSSYSSSSSSY
wSSSSSSSwSSSSSSSSwSSYSSSSSSYSSSSSSY
wwwwwwwwwwwwwwwwwwSSYYYYYYYYYYYYYYY

