RRRRRRRRSSBBBBBBBBBBBBBBBSSGGGGGGGG
RSSSSSSRSSBSSSSSSBSSSSSSBSSGSSSSSSG
RSSSSSSRRBBSSSSSSBSSSSSSBBGGSSSSSSG
RSSSSSSRRBBSSSSSSBSSSSSSBBGGSSSSSSG
RSSSSSSRSSBSSSSSSBSSSSSSBSSGSSSSSSG
RSSSSSSRSSBBBBBBBBBBBBBBBSSGGGGGGGG
RSSSSSSRSSSSSBBSSSSSBBSSSSSSSSGGSSS
RRRRRRRRSSBBBBBBBBSSYYSSSSSSSSYYSSS
RSSSSSSRSSBSSSSSSBSSYYYYYYYYYYYYYYY
RSSSSSSRSSBSSSSSSBSSYSSSSSSYSSSSSSY
RSSSSSSRSSBSSSSSSBSSYSSSSSSYSSSSSSY
RSSSSSSRSSBSSSSSSBSSYSSSSSSYSSSSSSY
RSSSSSSRSSBSSSSSSBSSYSSSSSSYSSSSSSY
RRRRRRRRSSBBBBBBBBSSYSSSSSSYSSSSSSY
SSSRRSSSSSSSSBBSSSSSYSSSSSSYSSSSSSY
SSSwwSSSSSSSSwwSSSSSYYYYYYYYYYYYYYY
wwwwwwwwwwwwwwwwwwSSYSSSSSSYSSSSSSY
wSSSSSSSwSSSSSSSSwSSYSSSSSSYSSSSSSY
wSSSSSSSwSSSSSSSSwwYYSSSSSSYSSSSSSY
wSSSSSSSwSSSSSSSSwwYYSSSSSSYSSSSSSY
wSSSSSSSwSSSSSSSSwSSYSSSSSSYSSSSSSY
wSSSSSSSwSSSSSSSSwSSYSSSSSSYSSSSSSY
wwwwwwwwwwwwwwwwwwSSYYYYYYYYYYYYYYY

