xRRRRRRRRSSBBBBBBBBBBBBBBBSSGGGGGGGGx
xR0SSSSS RSSB1SSSSS B2SSSSS BSSG3SSSSS Gx
xRSSSSSSRRBBSSSSSSBSSBBSSBBGGSSSSSSGx
xRSSSSSSRRBBSSSSSSBSSBBSSBBGGSSSSSSGx
xRSSSSSSRSSBSSSSSSBSSSSSSBSSGSSSSSSGx
xRSSSSSSRSSBBBBBBBBBBBBBBBSSGGGGGGGGx
xRSSSSSSRSSSSSBBSSSSSBBSSSSSSSSGGSSSx
xRRRRRRRRSSPPPPPPPPSSYYSSSSSSSSYYSSSx
xR4SSSSS RSSP5SSSSS PSSYYYYYYYYYYYYYYYx
xRSSSSSSRSSPSSSSSSPSSY6SSSSS Y7SSSSS Yx
xRSSRRSSRSSPSSSSSSPSSYSSSSSSYSSSSSSYx
xRSSSSSSRSSPSSSSSSPSSYSSSSSSYSSSSSSYx
xRSSSSSSRSSPSSSSSSPSSYSSSSSSYSSSSSSYx
xRRRRRRRRSSPPPPPPPPSSYSSSSSSYSSSSSSYx
xSSSRRSSSSSSSSPPSSSSSYSSSSSSYSSSSSSYx
xSSSwwSSSSSSSSwwSSSSSYYYYYYYYYYYYYYYx
xwwwwwwwwwwwwwwwwwwSSY10SSSSSY11SSSSSYx
xw8SSSSSS w9SSSSSSS wSSYSSSSSSYSSSSSSYx
xwSSSSSSSwSSSSSSSSwwYYSSSSSSYSSYYSSYx
xwSSSSSSSwSSSSSSSSwwYYSSSSSSYSSYYSSYx
xwSSSSSSSwSSSSSSSSwSSYSSSSSSYSSSSSSYx
xwSSSSSSSwSSSSSSSSwSSYSSSSSSYSSSSSSYx
xwwwwwwwwwwwwwwwwwwSSYYYYYYYYYYYYYYYx

