xRRRRRRRRSSBBBBBBBBBBBBBBBx
xR0SSSSS RSSB1SSSSS B2SSSSS Bx
xRSSSSSSRRBBSSSSSSBSSBBSSBx
xRSSSSSSRRBBSSSSSSBSSBBSSBx
xRSSSSSSRSSBSSSSSSBSSSSSSBx
xRRRRRRRRSSBBBBBBBBBBBBBBBx
xR4SSSSS RSSSSSBBSSSSSBBSSSx
xRSSRRSSRSSSSSPPSSSSSPPSSSx
xRSSRRSSRSSPPPPPPPPPPPPPPPSSYYYYYYYYx
xRSSSSSSRSSP5SSSSS P6SSSSS PSSY7SSSSS Yx
xRSSSSSSRSSPSSSSSSPSSSSSSPPYYSSSSSSYx
xRRRRRRRRSSPSSSSSSPSSSSSSPSSYSSSSSSYx
xSSSRRSSSSSPPPPPPPPPPPPPPPSSYSSSSSSYx
xSSSRRSSSSSSSSPPSSSSSSSSSSSSYSSSSSSYx
xSSSwwSSSSSSSSwwSSSSSSSSSSSSYSSSSSSYx
xwwwwwwwwwwwwwwwwwwwwwwwwwSSYYYYYYYYx
xw8SSSSSS ww9SSSSSS w10SSSSSwSSY11SSSSSYx
xwSSSSSSSwwSSSSSSSwSSSSSSwwYYSSYYSSYx
xwSSSSSSSwwSSSSSSSwSSSSSSwwYYSSYYSSYx
xwSSSSSSSwwSSSSSSSwSSSSSSwSSYSSSSSSYx
xwwwwwwwwwwwwwwwwwwwwwwwwwSSYYYYYYYYx